0,0,0,0,0,0,0,0,0,0,0,0,0,0,0,0,0,0,0,0,0,0,0,0,0,0,0,0,0,0,0,0
0,0,0,0,0,0,0,0,0,0,0,0,0,0,0,0,0,0,0,0,0,0,0,0,0,0,0,0,0,0,0,0
0,0,0,0,0,0,0,0,0,0,0,0,0,0,0,0,0,0,0,0,0,33,32,31,0,0,0,0,0,0,0,0
0,0,0,0,0,0,0,0,0,0,0,0,0,0,0,0,0,0,0,0,34,0,0,0,30,0,0,0,0,0,0,0
0,0,0,0,0,0,0,0,8,9,0,0,0,0,0,0,0,0,0,35,0,0,0,0,29,0,0,0,0,0,0,0
0,0,0,0,0,0,6,7,0,0,10,0,0,0,0,0,0,0,0,36,0,0,0,0,28,0,0,0,0,0,0,0
0,0,0,0,0,5,0,0,0,0,11,0,0,0,0,0,0,0,0,37,0,0,0,0,27,0,0,0,0,0,0,0
0,0,0,0,4,0,0,0,0,0,12,0,0,0,0,0,0,0,0,38,0,0,0,26,0,0,0,0,0,0,0,0
0,0,0,3,0,0,0,0,0,0,13,0,0,0,0,0,0,0,0,0,39,0,25,0,0,0,0,0,0,0,0,0
0,0,2,0,0,0,0,0,0,0,0,14,0,0,0,0,0,0,0,0,40,41,42,43,44,45,46,47,48,49,50,0
0,1,0,0,0,0,0,0,0,0,0,0,15,0,0,0,0,0,0,0,0,24,0,0,0,0,0,0,0,0,0,0
0,0,0,0,0,0,0,0,0,0,0,0,0,16,0,0,0,0,0,0,23,0,0,0,0,0,0,0,0,0,0,0
0,0,0,0,0,0,0,0,0,0,0,0,0,0,17,18,19,20,21,22,0,0,0,0,0,0,0,0,0,0,0,0
0,0,0,0,0,0,0,0,0,0,0,0,0,0,0,0,0,0,0,0,0,0,0,0,0,0,0,0,0,0,0,0
0,0,0,0,0,0,0,0,0,0,0,0,0,0,0,0,0,0,0,0,0,0,0,0,0,0,0,0,0,0,0,0
